2 2 2 2 2 2 2 2 2 2 2 2 2 2 2 2 2 2 2 2 2 2 2 2 2 2 2 2 2 2 2 2 
2 0 0 0 0 0 0 0 0 0 0 0 0 0 0 2 2 0 0 0 0 0 0 0 0 0 0 0 0 0 0 2 
2 0 0 0 0 0 0 0 0 0 0 0 0 0 0 2 2 0 0 0 0 0 0 0 0 0 0 0 0 0 0 2 
2 0 0 0 0 0 0 0 0 0 0 0 0 0 0 2 2 0 0 0 0 0 0 0 0 0 0 0 0 0 0 2 
2 0 0 0 0 0 0 0 0 0 0 0 0 0 0 2 2 0 0 0 0 0 0 0 0 0 0 0 0 0 0 2 
2 1 1 1 0 0 1 1 0 0 1 1 0 0 0 2 2 0 0 0 1 1 0 0 1 1 0 0 1 1 1 2 
2 0 0 0 0 0 0 0 0 0 0 0 0 0 0 2 2 0 0 0 0 0 0 0 0 0 0 0 0 0 0 2 
2 0 0 0 0 0 0 0 0 0 0 0 0 0 0 2 2 0 0 0 0 0 0 0 0 0 0 0 0 0 0 2 
2 0 0 0 0 0 0 0 0 0 0 0 0 0 0 2 2 0 0 0 0 0 0 0 0 0 0 0 0 0 0 2 
2 0 0 0 0 0 0 0 0 0 0 0 0 0 0 2 2 0 0 0 0 0 0 0 0 0 0 0 0 0 0 2 
2 0 0 1 1 1 1 1 1 1 1 1 0 0 0 2 2 0 0 0 1 1 1 1 1 1 1 1 1 0 0 2 
2 0 0 2 0 0 0 0 0 0 2 2 1 1 3 2 2 3 1 1 2 2 0 0 0 0 0 0 2 0 0 2 
2 0 0 2 0 1 1 0 0 0 0 0 0 0 0 0 0 0 0 0 0 0 0 0 0 1 1 0 2 0 0 2 
2 0 0 2 0 0 2 0 0 0 0 0 0 0 0 0 0 0 0 0 0 0 0 0 0 2 0 0 2 0 0 2 
2 0 0 2 2 2 2 0 0 0 0 0 0 1 1 0 0 1 1 0 0 0 0 0 0 2 2 2 2 0 0 2 
2 0 0 0 0 0 0 0 0 0 0 0 0 2 2 0 0 2 2 0 0 0 0 0 0 0 0 0 0 0 0 2 
2 0 0 0 0 0 0 0 0 0 0 1 1 2 2 0 0 2 2 1 1 0 0 0 0 0 0 0 0 0 0 2 
2 0 0 0 0 0 0 0 0 0 0 2 2 2 2 0 0 2 2 2 2 0 0 0 0 0 0 0 0 0 0 2 
2 0 0 0 0 0 0 0 0 1 1 2 2 2 2 0 0 2 2 2 2 1 1 0 0 0 0 0 0 0 0 2 
2 1 3 3 1 1 1 1 1 1 1 1 1 1 1 4 4 1 1 1 1 1 1 1 1 1 1 1 3 3 1 2  
6 14
./sprites/playerOne.png 31 5
./sprites/playerTwo.png 2 5
5 6 0 0 1
9 6 0 0 1
23 6 0 0 1
27 6 0 0 1

13 6
13 7
19 7